aber : what's up
acıktım : i am hungry
adım : my name
adın : your name
aklını : your mind
akşam : evening
akşamlar : evenings
alacak : will take / will buy
almak : to take / to buy
almanya : germany
altmış : sixty
altı : six
altın : gold
alçak : low
ama : but
amerika : america
anla : understand! (imperative)
anladı : he/she understood
anladım : i understood
anlamak : to understand
anlamadım : i didn't understand
anlamıyorlar : they don't understand
anlamıyorum : i don't understand
araba : car
arka : back
asla : never
aslında : actually / in fact
ay : month / moon
aydınlık : bright
ayrica : also
az : little / few
azından : at least
açık : open / light (colour)
açım : i'm hungry
ağır : heavy
aşağı : down / below
bak : look
bakır : copper
bana : (to) me
bayıldım : i loved it
bazen : sometimes
başladım : i started
bej : beige
bekle : wait
ben : i
beni : me
benim : my
beyaz : white
beş : five
bile : even
bilmek : to know
bilmiyordun : you didn't know
bilmiyorum : i don't know
bin : thousand
bir : one / a
biraz : a little
biri : someone
biz : we
bize : to us
boş : empty
bronz : bronze
bu : this
bugün : today
bulduk : we found
bulut : cloud
burada : here
buradayim : i am here
büyük : big
bırak : leave! / let go
da : also / too
daha : more
dan : from
deli : crazy
demek : to mean
dersi : the lesson
değil : not
değildi : was not
dilerim : i wish
doksan : ninety
dokuz : nine
dolu : full
doğru : right / correct
dört : four
dün : yesterday
düz : straight
dış : outside
eder : do / make
ederim : i do / thank you (polite)
eksik : missing / incomplete
elli : fifty
emin : sure / certain
en : most / the most
erkek : male
erken : early
eski : old
eve : to home
evet : yes
fantastik : fantastic
fazla : too much / a lot
fena : bad / awful
gece : night
geldin : you came
gelecek : future / will come
gelecekler : they will come
geliyorum : i am coming
gelmek : to come
genç : young
gercheckdin : really? (slang)
geç : late
geçen : last (e.g., last week)
gidecek : will go
gideceksin : you will go
gidelim : let's go
git : go!
gitmek : to go
gitmem : i must go
gittik : we went
gittim : i went
gittin : you went
görmek : to see
gördüm : i saw
gördün : you saw
görüşürüz : see you later
gri : grey
gökyüzü : sky
güneşli : sunny
güneşliydi : it was sunny
gün : day
günaydın : good morning
günler : days
gürültülü : noisy
güzel : beautiful / nice
güzeldi : was nice
hadi : come on
hafif : light (weight)
hafta : week
harika : great
hava : weather / air
hayran : impressed
hayır : no
hediyeyi : the gift
henüz : yet / still
her : every
herkes : everybody
hiç : none / ever
hiçbir : none / no (with noun)
hoşça : pleasantly (in goodbye)
hoşçakal : goodbye
hızlı : fast
ihtiyacım : my need
iki : two
ilgilendirmez : doesn't concern
inanılmaz : unbelievable
ince : thin
irlandalıyım : i am irish
istemek : to want
istiyorsun : you want
istiyorum : i want
iç : inside / (root) drink
içiyoruz : we are drinking
içmek : to drink
içmem : i must drink
içtiler : they drank
iş : work / job
iyi : good
iyiyim : i am fine
james : james
kadar : how much / as much
kahve : coffee
kahverengi : brown
kal : stay
kalın : thick
kanka : mate / buddy
kapalı : closed
kapanıyorsun : you are closing
karanlık : dark
karar : decision
kardeşim : my brother
kaç : how many / what time
kaçta : at what time
kaçırdın : you missed / lost
kedi : cat
kim : who
kimi : whom
kimse : nobody
kirli : dirty
kitap : book
kolay : easy
konuşabilir : can speak
konuşacaksınız : you (pl) will speak
konuşmak : to speak
konuştunuz : you (pl) spoke
konuşuyor : is speaking
konuşuyorum : i am speaking
konuşuyoruz : we are speaking
koyu : dark (colour)
kötü : bad
küçük : small
kırk : forty
kırmızı : red
kısa : short
kız : girl / daughter
kızım : my daughter
lacivert : navy blue
lazim / lazım : necessary / need to
lezzetli : delicious
lütfen : please
mavi : blue
memnun : pleased
merhaba : hello
milyar : billion
milyon : million
misin : are you? (sing.)
mor : purple
muhteşem : magnificent
musun : are you? (alt. form)
mutlu : happy
mühendisim : i am an engineer
mükemmel : perfect
mükemmeldi : was perfect
mı : (question particle)
nadiren : seldom
nasıl : how
nasılsın : how are you
nasıldı : how was (it)
ne : what
neden : why
nerede : where
neredeydi : where was
neredeyse : nearly
nerelisin : where are you from
nereye : to where
o : he / she / it
okula : to school
okumak : to read
okuyor : is reading
olacak : will be
oldum : i became / i was
on : ten
onlar : they
oradayim : i am there
oturuyorsun : you live / sit
otuz : thirty
oğlum : my son
pahalı / pahali : expensive
param : my money
peki : okay / well
pembe : pink
pratik : practice
project : project
rahat : comfortable
rica : favour / you're welcome
rüzgarlı : windy
rüzgarlıydı : it was windy
saat : hour / time
sabah : morning
sadece : only / just
sarı : yellow
sağ : right
sağa : to the right
sekiz : eight
seksen : eighty
sen : you
seni : you (object)
sert : hard
sessiz : quiet
seviyorum : i love
sevmek : to love
siyah : black
siz : you (plural / formal)
sol : left
sola : to the left
sonra : later / after
sonunda : in the end
sorum : my question
sorun : problem
soğuk : cold
su : water
susadım : i am thirsty
süt : milk
sıcak : hot
sıklıkla : often / frequently
tam : complete
tanıştığımıza : (that) we met
tatile : to holiday
tekrar : again
temiz : clean
teşekkür : thanks
teşekkürler : thank you
turkuaz : turquoise
turuncu : orange
türkçe / türkce : turkish (language)
türkiye : turkey
ucuz : cheap
unutacağım : i will forget
unuttum : i forgot
uzak : far
uzun : long
var : there is / there are
ve : and
verdim : i gave
verecek : he/she will give
vermek : to give
ya : or / hey
yakın : near
yanlış : wrong
yapacağız : we will do
yapmak : to do / make
yapmalısın : you must do
yapmam : i must do
yaptın : you did
yapıyorsun : you are doing
yapıyorsunuz : you (pl) are doing
yardım : help
yardıma : to help
yarın : tomorrow
yavaş : slow
yağdı : it rained
yağmur : rain
yağmıyor : it's not raining
yaşlı : old (age)
yaşındasın : (you) are years old
yaşıyorsun : you live
yaşıyorum : i live
yedi : seven
yedik : we ate
yedin : you ate
ye : eat! (imperative)
yemek : to eat / food
yemem : i must eat
yeni : new
yetmiş : seventy
yeşil : green
yirmi : twenty
yiyeceğim : i will eat
yiyelim : let's eat
yiyorum : i am eating
yok : there isn't / none
yoksa : or else / if not
yorgunum : i am tired
yukarı : up
yumuşak : soft
yüksek : high
yüz : hundred
yıl : year
zaman : time
zor : hard / difficult
çalışmak : to work / study
çalıştılar : they worked
çay : tea
çirkin : ugly
çocuğum : my child
çok : very / a lot
çünkü : because
ön : front
önce : before / ago
özür : sorry / apology
öğlen : noon
öğreniyorum : i am learning
öğrenmek : to learn
öğrenmeye : to learn (towards)
üzgün : sad / sorry
üç : three
şaşırtıcı : surprising
şehre : to the city
şeker : sugar
şey : thing
şeyi : the thing
şeylerle : with things
şimdi : now
